NO assets/textures/north.png
EA assets/textures/east.png
SO assets/textures/south.png
WE assets/textures/west.png

F 169,169,169
C 173,216,230


1111111111111111111111111
1000000000000000000000001
1010001000100010001000101
1000000000000000000000001
1000100010001000100010001
1000000000000000000000001
1010001000100010001000101
1000000000000000000000001
1000100010001000100010001
1000000000000000000000001
1000000000000000000000001
1100000000000000000000001
1111111110000000111111111
100000001000N000100000001
1000000010000000100000001
1111011111011101111101111
1111010000001000000101111
1110000000001000000000111
1100000000001000000000011
1000000000001000000000001
1000000000001000000000001
1000000000001000000000001
1010000000001010000000101
1000000000001000000000001
1111111111111111111111111