NO assets/textures/yellow.png
SO assets/textures/red.png
WE assets/textures/red.png
EA assets/textures/brown.png
F 169,169,169
C 173,216,230

11111111111111111111111111111111111111111111111111
10100011001010101010110000010100001010100010000101
10101111100000001010011111010111101010101110111101
10000110111011101011001101010111001010000110010101
11110010101110101001101100010101101010111111000101
11100110001100100011001111010101001010111011011101
10001111101110111011011000010101100000000011010001
11100110100000010010001101000001001101011010000111
10101100111111011010111111101101100111111111011111
10000001110010011000011010111000001110101100000001
10111101011011001101000000111111101010101110111111
10110100010000011001011111101110001000000000000111
11100111011110111111001010101011101011011111111101
11110110001100101010011010101011000001111011010101
10100011101001101011011000001001101111000000000001
10110110001101101010001111101101101011110111010111
10000011101101100000111010000101101001100011111101
11111011001001111011101011110101101011101110101101
10001011101101011010101011010101001011001010101101
11101010000001010010101010000001100001100010000001
10101011111101011000101011111011110111001000111011
10000000001101011110101010010010100000011101101111
10111101100001010000001011000110101111111111100001
10100000111100000111101001110100101110101010001111
10110111110001110110000011010110000010101000100001
11111111100101100011101000010100101110000011111111
11011000111101101011111011000001111000101000000001
10001010011111111110000001111011111110111111110111
11101111010111010100101101000010101010010001111111
10001101010000000111111111101000000000110111001001
11101000011111110101010111111101111010010110011011
11101111010000000000000001010100001111000010110001
10000000000110111111110100000001111101111110000101
11011101110110110001011111111100000000001000101101
10010001000110110100001011000001010101100011100101
10111011110111100110100000010111111101101000111101
10011111110001101111110101010000001100101010000101
11110101000101001011011111010101101101101011011111
10000000010111101010000000010101100101101110001011
10110111010011111000111101010100101111000111100001
11110100011001011101111111010101100011010011001011
11000101011011000001100000010100110111110111011001
10011101110001111101101010110101100000110101011011
11010001111111111101111110110100110110110001111111
11110101000111000000110000110101100011110100000101
10000101010000010101111110111101001111100101110001
11011111111101010101100000011101101110111100111101
10011010110001011101101101000111000000000101101101
101100000001010100010011010101100101101011000011N1
11111111111111111111111111111111111111111111111111