NO assets/textures/yellow.png
SO assets/textures/red.png
WE assets/textures/red.png
EA assets/textures/brown.png
F 169,169,169
C 173,216,230

11111111111111111111
10000000000000000001
10000000000000000001
10000000000000000001
100N0000000000000001
10000000000000000001
10000000000000000001
10000000000000000001
10000000000000000001
10000000000000000001
10000000000000000001
10000000000000000001
10000000000000000001
10000000000000000001
10000000000000000001
10000000000000000001
10000000000000000001
10000000000000000001
10000000000000000001
11111111111111111111