NO assets/textures/grey.png
EA assets/textures/grey.png
SO assets/textures/grey.png
WE assets/textures/grey.png

F 0,255,0
C 0,255,0


11111
10001
10N01
10001
11111