NO assets/textures/grey.png
SO assets/textures/grey.png
WE assets/textures/grey.png
EA assets/textures/grey.png
F 169,169,169
C 173,216,230

1111111
1000101
1010101
1010101
1N10001
1111111