NO assets/textures/north.png
EA assets/textures/east.png
SO assets/textures/south.png
WE assets/textures/west.png

F 169,169,169
C 173,216,200


1111111
1100001
1000101
1000001
100N001
1001001
1111111