NO assets/textures/yellow.png
SO assets/textures/red.png
WE assets/textures/red.png
EA assets/textures/brown.png
F 169,169,169
C 173,216,230

1111111111111
1000000000001
1000000011111
100N000000001
1000000000001
1111111111111