NO assets/textures/north.png
EA assets/textures/east.png
SO assets/textures/south.png
WE assets/textures/west.png

F 169,169,169
C 173,216,230


1111111111
1100001111
1100101111
E100001111
1100001111
1001001111
1111111111