NO assets/textures/north.png
EA assets/textures/east.png
SO assets/textures/south.png
WE assets/textures/west.png

F 169,169,169
C 173,216,230


1111111
1100001
1000101
100N001
1000001
1001001
1111111